// 8x8
// dist[width][width] array

// max value = width - 2
6	5	4	3	3	4	5	6
5	4	3	2	2	3	4	5
4	3	2	1	1	2	3	4
3	2	1	0	0	1	2	3
3	2	1	0	0	1	2	3
4	3	2	1	1	2	3	4
5	4	3	2	2	3	4	5
6	5	4	3	3	4	5	6
